10 10 10 11 10 10 10 10 10 10 10 10 11 11 11 10 10 10 10 10 11 11 10 10 10 10 11 11 10 10 10 10
10 9 9 9 9 9 9 9 9 9 14 6 5 6 5 31 10 3 66 7 7 7 37 10 10 37 8 8 8 66 8 10
10 15 10 10 10 10 10 10 10 10 10 5 6 5 6 5 10 7 67 7 7 7 7 10 10 8 8 4 8 67 8 10
10 9 9 37 37 9 9 9 9 9 10 33 5 6 5 6 10 7 7 7 40 7 7 10 10 8 8 8 8 8 8 10
10 9 9 9 9 9 9 9 7 9 10 33 33 33 32 5 10 7 7 7 34 7 7 10 10 8 8 8 8 8 8 10
10 10 15 10 10 10 10 7 7 7 10 10 10 10 10 15 10 10 10 10 10 10 18 10 10 19 10 10 10 10 10 10
12 7 7 7 7 35 10 7 7 7 7 7 7 7 7 7 14 8 8 8 8 8 7 7 7 7 7 9 9 9 35 12
12 7 7 7 7 7 10 7 7 40 40 40 40 40 7 35 10 8 8 8 8 8 7 7 7 7 7 9 9 85 9 12
13 1 7 7 7 7 14 7 7 34 34 34 34 34 7 7 10 10 10 10 10 10 10 10 10 7 7 9 9 9 9 12
13 7 7 7 7 7 14 7 7 34 34 34 34 34 7 35 10 72 9 9 9 9 9 35 10 9 9 9 9 9 9 12
12 7 7 7 7 7 10 7 7 41 41 41 41 41 7 7 10 9 42 34 9 9 9 9 14 9 9 9 9 86 9 12
12 7 7 7 7 35 10 35 7 35 7 7 7 35 7 35 10 9 9 9 9 9 9 35 10 9 9 73 9 9 35 12
10 10 10 10 15 10 10 10 10 10 10 15 10 10 10 10 10 10 10 10 10 10 10 10 10 10 15 10 10 10 10 10
10 37 37 8 8 8 8 35 10 38 6 5 6 10 37 35 10 2 60 60 9 9 9 14 9 9 9 9 37 37 37 10
10 8 8 8 8 8 8 8 10 6 5 6 5 10 9 9 10 9 60 60 9 70 35 10 9 9 9 9 9 9 9 10
10 8 8 8 8 8 16 8 10 5 6 5 6 10 9 9 10 9 60 60 9 71 9 10 35 9 9 9 9 9 34 10
10 35 8 8 8 8 8 35 10 6 36 6 5 14 9 9 10 9 9 9 9 9 9 10 35 9 34 34 34 34 34 10
10 10 10 10 10 11 11 10 10 11 10 10 10 10 10 10 10 17 17 17 17 17 17 10 10 11 10 10 10 10 10 10